BKKKKKKKKKKKKlkKKKKKKKKKKKKA
DooooommmmmmmZYmmmmmmmmmmmmC
DmXUUWmXUUUWmZYmXUUWmXUUUWmC
DmZmmYmZmmmYmZYmZmmYmZmmmYmC
Dm\VV[m\VVV[mZYm\VV[m\VVV[mC
Dmmmmmmmmmmmm\[mmmmmmmmmmmmC
DmmmmmmmmmmmmmmmmmmmmmmmmmmC
FMMMMMMMMMMMMMMMMMMMMMMMMMME